11111111111111
12222222222221
12111211111121
131 121 122221
12111211121111
12222222222221
12111211111121
1222222215  51
121111121 1111
122222121 1 11
11111111111111