111111111111111
112222252222221
112111111211121
1222221 121 131
111112111211121
112222222222221
112111111211121
1 4   122222521
1 111 121111121
1 1 1 121111211
1 2 2 222222221
111111111111111