11111111111111
11111222  1111
125222121 1  1
121111121 1 11
12222222222221
12111211111121
13221     4  1
11121112121111
12222225122221
12111111111121
12222222222221
11111111111111