111111111111111
112222        1
112111111 111 1
1  4  1 1 1 131
11111 111 111 1
11            1
11 111111 111 1
1     1     5 1
1 111 1 11111 1
1 1 1 1 1111 11
1       5   221
111111111111111