111111111111111111111111111
122222222222212222222222221
121112111111212111111211121
131 121 12222222221 121 131
121112111211111112111211121
122222222222212222222222221
121112111111212111111211121
1222222215       4122222221
121111121 111 111 121111121
122222121 1 1 1 1 121222221
11111222  111 111  22211111
122222121 1     1 121222221
121111121 1 111 1 121111121
122222222222212222222222221
121112111111212111111211121
13221                 12231
111211121211111112121112111
122222221222212222122222221
121111111111212111111111121
122222222222222222222222221
111111111111111111111111111