11111111
14     1
1  1   1
1  1   1
1  1   1
1     51
11111111
