1111111
1242221
1211121
1222221
1211121
1225221
1111111
