%%%%%%%%%%%%%%%%%%%%%%%%%%%
%............%............%
%.%%%.%%%%%%.%.%%%%%%.%%% %
%o% %.% %.........% %.% % %
%.%%%.%%%.%%%%%%%.%%%.    %
%............%....... .   %
%.%%%.%%%%%%.%.%%%%%%P%%% %
%.......%         %       %
%.%%%%%.% %%% %%% % %%%%% %
%.....%.% % % % % % %     %
%%%%%...  %%% %%%     %%%%%
%.....%.% %     % %.%.....%
%.%%%%%.% % %%% % %.%%%%%.%
%............%............%
%.%%%.%%%%%%.%.%%%%%%.%%%.%
%o..%                 %..o%
%%%.%%%.%.%%%%%%%.%.%%%.%%%
%.......%....%....%.......%
%.%%%%%%%%%%.%.%%%%%%%%%%.%
%.........................%
%%%%%%%%%%%%%%%%%%%%%%%%%%%