11111111111111111111
1    1        1    1
1 11 1 111111 1 11 1
1 1              1 1
1 1 11 11  11 11 1 1
1      15  51      1
1 1 11 111111 11 1 1
1 1              1 1
1 11 1 111111 1 11 1
1    1   4    1   31
11111111111111111111
