1111111
1 4   1
1 111 1
1 1   1
1 111 1
1  5  1
1111111
