111111111111111111111111111
122222222222212222222222221
121112111111212111111211121
131012101222222222101210131
121112111211111112111211121
122222222222212222222222221
121112111111212111111211121
122222221500504004122222221
121111121011101110121111121
122222121010101010121222221
111112220011101110022211111
122222121010000010121222221
121111121010111010121111121
122222222222212222222222221
121112111111212111111211121
132210400040000050005012231
111211121211111112121112111
122222221222212222122222221
121111111111212111111111121
122222222222222222222222221
111111111111111111111111111