1111111
1242221
1211121
1223221
1211151
1225221
1111111
