1111111
1222221
1211121
1223421
1211151
1225221
1111111
