%%%%%%%
%P....%
%.%%%.%
%..o..%
%.%%%.%
%.....%
%%%%%%%
