%%%%%%%
%P....%
%.%.%.%
%..o..%
%.%.%.%
%.....%
%%%%%%%
