1111111
1242221
1212121
1212121
1212121
1225221
1111111
