%%%%%%%%
%.....%%
%.% %.%%
%.%o%  %
%.%P   %
%... . %
%%%%%%%%