1111111
1     1
1411211
1 1 221
15121 1
1 2 121
1111111
