1111111
1     1
141 121
1 1 121
15121 1
1 2  21
1111111
