1111111
124   1
1 13131
1 1 151
1 121 1
1 25 21
1111111
