111111111
142 212 1
121121211
12 122521
121111121
12 22 221
111111111