11111111111
14222222221
12111211121
12111211121
12111211121
12222252221
12111211121
12111211121
12111211121
12222222251
11111111111