11111111111
14    2 221
12111 11121
1 111 111 1
12111 11121
12222 52221
1 111 11121
12111 11121
12111 11121
12222    51
11111111111