11111111111
15    2 221
12111 11121
1 111 111 1
12111 11121
122224 2221
1 111 11121
12111 11121
12111 11121
12222    51
11111111111