111111111
142222221
121121121
121121121
122222221
121121151
121121121
122225221
111111111