11111111111
124222   21
121111 11 1
122 52    1
11111111111
