11111111111
124222   21
121111 11 1
12 212311 1
12111211121
12222522521
11111111111
